Professor	Professor(教授)
chair professor	Professor(教授)
chair professor	Professor(教授)
Distinguished professor	Professor(教授)
Endowed  professor	Professor(教授)
Adjunct Professor	Professor(教授)
emeritus professor	Professor(教授)
full professor	Professor(教授)
Professori	Professor(教授)
Professor.	Professor(教授)
Professors	Professor(教授)
Professora	Professor(教授)
Univ.-Prof.	Professor(教授)
Pro­fes­sor	Professor(教授)
Professor emeritus	Professor(教授)
Professor Titular	Professor(教授)
Professor Emeritu	Professor(教授)
Professor Emerita	Professor(教授)
Lifetime Professor Emeritus	Professor(教授)
Engineering Professor	Professor(教授)
PROFESOR	Professor(教授)
讲席教授	Professor(教授)
教授	Professor(教授)
教 授	Professor(教授)
准教授	Professor(教授)
Full-Professor	Professor(教授)
二级教授	Professor(教授)
特聘教授	Professor(教授)
prof.	Professor(教授)
professeure	Professor(教授)
professeur	Professor(教授)
PROFESSORE ASSOCIATO	Associate Professor(副教授)
副教授	Associate Professor(副教授)
Associated Professor	Associate Professor(副教授)
Associate Professor	Associate Professor(副教授)
Associate Research Professor	Associate Professor(副教授)
Assoc. Prof.	Associate Professor(副教授)
Assoc Prof	Associate Professor(副教授)
Assoc. Professor	Associate Professor(副教授)
ADJUNCT ASSOCIATE PROFESSOR	Associate Professor(副教授)
Assoc Professor	Associate Professor(副教授)
助理教授	Assistant Professor(助理教授)
Professor (Assistant)	Assistant Professor(助理教授)
Assistant Research Professor	Assistant Professor(助理教授)
Assistant Professor	Assistant Professor(助理教授)
讲师	Lecturer(讲师)
senior lecturer	Lecturer(讲师)
Lecturer	Lecturer(讲师)
教授级高级工程师	Professorate Senior Engineer(教授级高级工程师)
Professorate Senior Engineer	 Professorate Senior Engineer(教授级高级工程师)
Senior Principal Engineer	Senior Engineer(高级工程师)
高级工程师	Senior Engineer(高级工程师)
Senior Engineer	Senior Engineer(高级工程师)
工程师	Engineer(工程师)
Distinguished Engineer	Engineer(工程师)
Senior Consulting Engineer	Engineer(工程师)
Senior Staff Engineer	Engineer(工程师)
Principal R&D Engineer	Engineer(工程师)
an Engineer	Engineer(工程师)
the Engineering 	Engineer(工程师)
助理工程师	Assistant Engineer(助理工程师)
Assistant Engineer	Assistant Engineer(助理工程师)
研究员	Researcher(研究员)
Investigator	Researcher(研究员)
senior research scientist	Researcher(研究员)
Scientific Researcher	Researcher(研究员)
research fellow	Researcher(研究员)
副研究员	Associate Researcher(副研究员)
Associate Researcher	Associate Researcher(副研究员)
Associate Research Fellow	Associate Researcher(副研究员)
助理研究员	Assistant Researcher(助理研究员)
research associate	Associate Researcher(副研究员)
Assistant Researcher	Assistant Researcher(助理研究员)
Assistant Research Fellow	Assistant Researcher(助理研究员)